################
#..............#
#..............#
#..###....##...#
#..#.#....#....#
#..#.#....#.##.#
#..........#...#
#..........#...#
#......###.....#
#......#.#.....#
#..#...#.#..#..#
#..#......#....#
#..###..###....#
#..............#
#..............#
################
